[Bricks]
1 1 1 1 1 1 1 1 1 1 	 
1 5 5 5 5 5 5 5 5 1 	 
1 5 5 5 5 5 5 5 5 1 	 
1 3 3 1 3 3 1 3 3 1 	 
1 3 3 3 3 3 3 3 3 1 	 
1 2 2 2 2 2 2 2 2 1 	 
1 2 2 2 2 2 2 2 2 1 	 
1 2 2 1 2 2 1 2 2 1 	
1 2 2 2 1 1 2 2 2 1
3 3 3 3 3 3 3 3 3 3 	 
2 2 2 2 2 2 2 2 2 2 	 
2 2 2 2 2 2 2 2 2 2
0 0 0 0 0 0 0 0 0 0
0 0 1 0 0 0 0 1 0 0
0 1 0 0 0 0 0 0 1 0
1 0 0 0 0 0 0 0 0 1
0 0 0 0 0 0 0 0 0 0
0 0 0 0 0 0 0 0 0 0
0 0 0 0 0 0 0 0 0 0
0 0 0 0 0 0 0 0 0 0
[end]


[Bonuses]
3 3 3 3 3 3 3 3 3 3
1 1 1 1 1 1 1 1 1 1
3 3 3 3 3 3 3 3 3 3
1 1 1 1 1 1 1 1 1 1
3 3 3 3 3 3 3 3 3 3
1 1 1 1 1 1 1 1 1 1
3 3 3 3 3 3 3 3 3 3 
1 1 1 1 1 1 1 1 1 1
3 3 3 3 3 3 3 3 3 3
1 1 1 1 1 1 1 1 1 1
2 2 3 2 2 2 2 3 2 2
2 2 3 2 2 2 2 3 2 2 
[end]